1 17 31
###############################
# p    ** *  1 * 2 *  * * *   #
#                             #
#  x*     ***  *  1   * 2 * * #
#                             #
#f         x **  *  *   1     #
#   ####################      #
#*  *      *  *      *        #
# # # # #*# # # #*#*# # # # # #
#*    **  *       *           #
# #*# # # # # # #*# # # # # # #
#           *   *  *          #
# #*# # # # # # #*# # # # # # #
#           *   *  *          #
# #*# # # # # # #*# # # # # # #
#           *   *  *          #
###############################